Teacher's Favourite Books

**To Kill a Mockingbird - Harper Lee
/The Lord of the Rings (series) - J.R.R. Tolkien
The Book Thief - Markus Zusak
|The Hobbit - J.R.R. Tolkien
-The Great Gatsby - F. Scott Fitzgerald
**The Kite Runner - Khaled Hosseini
/The Hunger Games (series) - Suzanne Collins
*The Time Traveller's Wife - Audrey Niffenger
**The Chronicles of Narnia (series) - C.S. Lewis
Of Mice and Men - John Steinbeck
Birdsong - Sebastian Faulks
/His Dark Materials (series) - Philip Pullman
The Gruffalo - Julia Donaldson and Axel Schleffler
*The Catcher in the Rye - J.D. Salinger
*Life of Pi - Yann Martel
Rebecca - Daphne du Maurier
**The Curious Incident of the Dog in the Night Time - Mark Haddon
/Lord of the Flies - William Golding
/Matilda - Roald Dahl
*Catch 22 - Joseph Heller
Millennium (series) - Steig Larsson
The Handmaid's Tale - Margaret Atwood
-Persuasion - Jane Austen
100 Years of Solitude - Gabriel Garcia Marquez
Kensuke's Kingdom - Michael Morpungo
*The Grapes of Wrath - John Steinbeck
Little Women - Louisa May Alcott
One Day - David Nicholls
*We Need to Talk About Kevin - Lionel Shriver
Wolf Hall - Hilary Mantel
**A Thousand Splendid Suns - Khaled Hosseini
-The Wind in the Willows - Kenneth Grahame
-Great Expectations - Charles Dickens
*The Hitchhiker's Guide to the Galaxy - Douglas Adams
Room - Emma Donoghue
Anna Karenina - Leo Tolstoy
**Atonement - Ian McEwan
Emma - Jane Austen
Middlemarch - George Eliot
The Shadow of the Wind - Carlos Ruiz Zafon
The Color Purple - Alice Walker
The Very Hungry Caterpillar - Eric Carle
Brave New World - Aldous Huxley
Sense and Sensibility - Jane Austen
The Bell Jar - Sylvia Plath
/Charlotte's Webb - E.B. White
The Secret History - Donna Tartt
Crime and Punishment - Fyodor Dostoevsky
Jude the Obscure - Thomas Hardy
Skellig - David Almond
The Woman in White - Wilkie Collins
**Gone with the Wind - Margaret Mitchell
Game of Thrones (series) - George R.R. Martin
David Copperfield - Charles Dickens
-Never Let Me Go - Kazuo Ishiguro
Where the Wild Things Are - Maurice Sendak
Beloved - Toni Morrison
The Help - Kathyrn Stockett
*Sherlock Holmes (series) - Arthur Conan Doyle
Half of a Yellow Sun - Chimamanda Ngozi Adichie
Moneyball - Michael Lewis
Memoirs of a Geisha - Arthur Golden
On the Road - Jack Kerouac
Cloud Atlas - David Mitchell
Wild Swans - Jung Chang
Anne of the Green Gables - L.M. Montgomery
-Les Miserables - Victor Hugo
Private Peaceful - Michael Morpungo
Noughts and Crosses - Malorie Blackman
Cider with Rosie - Laurie Lee
Down and Out of Paris and London - George Orwell
The God of Small Things - Arundhati Roy
/Holes - Louis Sachar

one flew over the cuckoo's nest - ken kesy
paradise lost - john milton
old man and the sea - ernest hemingway
for whom the bell tolls - ernest hemingway
the bell jar - sylvia plath
-war and peace - leo tolstoy
and the mountains echoed - Khaled Hosseini